60 40
130 130 130 130 130 130 322 323 398 399 403 404 410 411 398 399 403 404 359 360 130 130 130 130 130 130 130 130 130 130 130 130 130 398 399 403 404 410 411 403 404 398 399 410 411 403 404 398 399 410 411 403 404 410 411 398 399 130 130 130
130 130 130 130 322 323 386 387 462 463 467 468 474 475 462 463 467 468 423 424 403 404 359 360 130 130 130 130 130 130 130 130 524 462 463 467 468 474 475 467 468 462 463 474 475 467 468 462 463 474 475 467 468 474 475 462 463 418 130 130
130 130 130 130 386 387 450 451 526 527 -1 -1 -1 -1 526 527 -1 -1 487 488 467 468 423 424 359 360 130 322 323 398 399 389 390 526 527 -1 -1 -1 -1 -1 -1 526 527 -1 -1 -1 -1 526 527 -1 -1 -1 -1 -1 -1 526 527 482 542 130
130 130 130 524 450 451 -1 -1 -1 -1 -1 -1 -1 -1 -1 -1 -1 -1 -1 -1 -1 -1 487 488 423 424 406 386 387 462 463 453 454 -1 -1 -1 -1 -1 -1 -1 -1 -1 -1 -1 -1 -1 -1 -1 -1 -1 -1 -1 -1 -1 -1 -1 -1 -1 420 421
130 130 389 390 -1 -1 -1 -1 -1 -1 -1 -1 -1 -1 -1 -1 -1 -1 -1 -1 -1 -1 -1 -1 487 488 470 450 451 526 527 -1 -1 -1 -1 -1 -1 -1 -1 -1 -1 -1 -1 -1 -1 -1 -1 -1 -1 -1 -1 -1 -1 -1 -1 -1 -1 -1 484 485
130 130 453 454 -1 -1 -1 -1 -1 -1 -1 -1 -1 -1 -1 -1 -1 -1 -1 -1 -1 -1 -1 -1 -1 -1 534 -1 -1 -1 -1 -1 -1 -1 -1 -1 -1 -1 -1 -1 -1 -1 -1 -1 -1 -1 -1 -1 -1 -1 -1 -1 -1 -1 -1 -1 -1 -1 -1 -1
130 1292 -1 -1 -1 -1 -1 -1 -1 -1 -1 -1 -1 -1 -1 -1 -1 -1 -1 -1 -1 -1 -1 -1 -1 -1 -1 -1 -1 -1 -1 -1 -1 -1 -1 -1 -1 -1 -1 -1 -1 -1 -1 -1 -1 -1 -1 -1 -1 -1 -1 -1 -1 -1 -1 -1 -1 -1 -1 -1
130 1356 -1 -1 -1 -1 -1 -1 -1 -1 -1 -1 -1 -1 -1 -1 -1 -1 -1 -1 -1 -1 -1 -1 -1 -1 -1 -1 -1 -1 -1 -1 -1 -1 -1 -1 -1 -1 -1 -1 -1 -1 -1 -1 -1 -1 -1 -1 -1 -1 -1 -1 -1 -1 -1 -1 -1 -1 -1 -1
1294 1295 -1 -1 -1 -1 -1 -1 -1 -1 -1 -1 -1 -1 -1 -1 -1 -1 -1 -1 -1 -1 -1 -1 -1 -1 -1 -1 -1 -1 -1 -1 -1 -1 -1 -1 -1 -1 -1 -1 -1 -1 -1 -1 -1 -1 -1 -1 -1 -1 -1 -1 -1 -1 -1 -1 -1 -1 -1 -1
1358 1359 -1 -1 -1 -1 -1 -1 -1 -1 -1 -1 -1 -1 -1 -1 -1 -1 -1 -1 -1 -1 -1 -1 -1 -1 -1 -1 -1 -1 -1 -1 -1 -1 -1 -1 -1 -1 -1 -1 -1 -1 -1 -1 -1 -1 -1 -1 -1 729 730 1493 1494 1496 1497 1486 1487 1489 1493 1494
1294 1295 -1 -1 -1 -1 -1 -1 -1 -1 -1 -1 -1 -1 -1 -1 -1 -1 -1 -1 -1 -1 -1 -1 -1 -1 -1 -1 -1 -1 -1 -1 -1 -1 -1 -1 -1 -1 -1 -1 -1 -1 -1 -1 -1 -1 -1 -1 -1 793 794 1557 1558 1560 1561 1550 1551 1553 1557 1558
1358 1359 -1 -1 -1 -1 -1 -1 -1 -1 -1 -1 -1 -1 -1 -1 -1 -1 -1 -1 -1 -1 -1 -1 -1 -1 -1 -1 -1 -1 -1 -1 -1 -1 -1 -1 -1 -1 -1 -1 -1 -1 -1 993 994 -1 -1 -1 -1 -1 544 423 424 130 130 130 130 130 130 130
130 1292 -1 -1 -1 -1 -1 -1 -1 729 730 1493 1494 1491 1493 1494 1499 1500 1486 1487 720 721 -1 -1 -1 -1 -1 -1 -1 -1 -1 -1 -1 -1 -1 -1 993 994 -1 -1 -1 -1 -1 -1 -1 -1 -1 -1 -1 -1 -1 487 488 542 130 130 130 130 130 130
130 1356 -1 -1 -1 -1 -1 -1 -1 793 794 1557 1558 1555 1557 1558 1563 1564 1550 1551 784 785 -1 -1 -1 -1 -1 -1 -1 -1 -1 -1 -1 -1 -1 -1 -1 -1 -1 -1 -1 -1 -1 -1 -1 -1 -1 -1 -1 -1 -1 -1 -1 420 421 359 360 130 130 130
1294 1295 -1 -1 -1 -1 -1 -1 -1 -1 544 467 468 474 475 470 462 463 474 475 522 -1 -1 -1 -1 -1 -1 -1 -1 993 994 -1 -1 -1 -1 -1 -1 -1 -1 -1 -1 -1 -1 -1 -1 -1 -1 -1 -1 -1 -1 -1 -1 484 485 423 424 130 130 130
1358 1359 -1 -1 -1 -1 -1 -1 -1 -1 -1 -1 -1 -1 -1 534 526 527 -1 -1 -1 -1 -1 -1 -1 -1 -1 -1 -1 -1 -1 -1 -1 -1 -1 -1 -1 -1 -1 -1 -1 -1 -1 -1 -1 -1 -1 -1 -1 -1 -1 -1 -1 -1 -1 487 488 418 130 130
130 1484 720 721 -1 -1 -1 -1 -1 -1 -1 -1 -1 -1 -1 -1 -1 -1 -1 -1 -1 -1 -1 -1 -1 -1 -1 -1 -1 -1 -1 -1 -1 -1 -1 -1 -1 -1 -1 -1 -1 -1 -1 -1 -1 -1 -1 -1 -1 -1 -1 -1 -1 -1 -1 -1 -1 482 542 130
130 1548 784 785 -1 -1 -1 -1 -1 -1 -1 -1 -1 -1 -1 -1 -1 -1 -1 -1 -1 -1 -1 -1 -1 -1 -1 -1 -1 -1 -1 -1 -1 -1 -1 -1 -1 -1 -1 -1 -1 -1 -1 -1 -1 -1 -1 -1 -1 -1 -1 -1 -1 -1 -1 -1 -1 -1 1307 1308
130 130 130 1484 648 649 -1 -1 -1 -1 -1 -1 -1 -1 -1 -1 -1 -1 -1 -1 -1 -1 -1 -1 -1 -1 -1 -1 -1 -1 -1 -1 -1 -1 -1 -1 -1 -1 -1 -1 -1 -1 -1 -1 -1 -1 -1 -1 -1 -1 -1 -1 -1 -1 -1 -1 -1 -1 1371 1372
130 130 130 1548 712 713 645 646 -1 -1 -1 -1 -1 -1 -1 -1 -1 -1 -1 -1 -1 -1 -1 -1 -1 -1 -1 -1 -1 -1 -1 -1 -1 -1 -1 -1 -1 -1 -1 -1 -1 -1 -1 -1 -1 -1 -1 -1 -1 -1 -1 -1 -1 -1 -1 -1 -1 -1 1310 130
130 130 130 130 776 777 709 710 1493 1494 720 721 -1 -1 -1 -1 -1 -1 -1 -1 -1 -1 -1 -1 -1 -1 -1 -1 -1 -1 -1 -1 -1 -1 -1 -1 -1 -1 -1 -1 -1 -1 -1 -1 -1 -1 -1 -1 -1 -1 -1 -1 -1 -1 -1 -1 -1 -1 1374 130
130 130 130 130 322 323 403 404 1557 1558 784 785 -1 -1 -1 -1 -1 -1 -1 -1 -1 -1 -1 -1 -1 -1 -1 -1 -1 -1 -1 -1 -1 -1 -1 -1 -1 -1 -1 -1 -1 -1 -1 -1 729 730 1496 1497 1493 1494 1486 1487 1493 1494 1496 1497 1499 1500 1502 130
130 130 130 130 386 387 467 468 462 463 522 -1 -1 -1 968 969 -1 -1 -1 -1 -1 -1 -1 -1 -1 -1 -1 -1 -1 -1 -1 -1 -1 -1 -1 -1 -1 -1 -1 968 969 -1 -1 -1 793 794 1560 1561 1557 1558 1550 1551 1557 1558 1560 1561 1563 1564 130 130
130 130 130 524 450 451 -1 -1 526 527 -1 -1 -1 -1 -1 -1 -1 -1 -1 -1 -1 -1 -1 -1 -1 -1 -1 -1 -1 -1 -1 -1 -1 -1 -1 -1 -1 -1 -1 -1 -1 -1 -1 -1 -1 544 130 130 130 130 130 130 130 130 130 130 130 130 130 130
130 130 389 390 -1 -1 -1 -1 -1 -1 -1 -1 -1 -1 -1 -1 -1 -1 -1 -1 -1 -1 -1 -1 -1 -1 -1 -1 -1 -1 -1 -1 -1 -1 -1 -1 -1 -1 -1 -1 -1 -1 -1 -1 -1 -1 420 421 359 360 130 130 130 130 130 130 130 130 130 130
130 524 453 454 -1 -1 -1 -1 -1 -1 -1 -1 -1 -1 -1 -1 -1 -1 -1 -1 -1 -1 968 969 -1 -1 -1 -1 -1 -1 -1 968 969 -1 -1 -1 -1 -1 -1 -1 -1 -1 -1 -1 -1 -1 484 485 423 424 359 360 130 130 130 130 130 130 130 130
130 1292 -1 -1 -1 -1 -1 -1 -1 -1 -1 -1 -1 -1 -1 -1 -1 -1 -1 -1 -1 -1 -1 -1 -1 -1 -1 -1 -1 -1 -1 -1 -1 -1 -1 -1 -1 -1 -1 -1 -1 -1 -1 -1 -1 -1 -1 -1 487 488 423 424 398 399 403 404 130 130 130 130
130 1356 -1 -1 -1 -1 -1 -1 -1 -1 -1 -1 -1 -1 -1 -1 -1 -1 -1 -1 -1 -1 -1 -1 -1 -1 -1 -1 -1 -1 -1 -1 -1 -1 -1 -1 -1 -1 -1 -1 -1 -1 -1 -1 -1 -1 -1 -1 -1 -1 487 488 462 463 467 468 542 130 130 130
130 1292 -1 -1 -1 -1 -1 -1 -1 -1 -1 -1 -1 -1 -1 -1 -1 -1 -1 -1 -1 -1 -1 -1 -1 -1 -1 -1 -1 -1 -1 -1 -1 -1 -1 -1 -1 -1 -1 -1 -1 -1 -1 -1 -1 -1 -1 -1 -1 -1 -1 -1 526 527 -1 -1 420 421 130 130
130 1356 -1 -1 -1 -1 -1 -1 -1 -1 -1 -1 -1 -1 -1 -1 -1 968 966 969 -1 -1 -1 -1 -1 -1 -1 -1 -1 -1 -1 -1 -1 -1 993 993 994 -1 -1 -1 -1 -1 -1 -1 -1 -1 -1 -1 -1 -1 -1 -1 -1 -1 -1 -1 484 485 542 130
1294 1295 -1 -1 -1 -1 -1 -1 -1 -1 -1 -1 -1 -1 -1 -1 -1 -1 -1 -1 -1 -1 -1 -1 -1 -1 -1 -1 -1 -1 -1 -1 -1 -1 -1 -1 -1 -1 -1 -1 -1 -1 -1 -1 -1 -1 -1 -1 -1 -1 -1 -1 -1 -1 -1 -1 -1 -1 1307 1308
1358 1359 -1 -1 -1 -1 -1 -1 -1 -1 -1 -1 -1 -1 -1 -1 -1 -1 -1 -1 -1 -1 -1 -1 -1 -1 -1 -1 -1 -1 -1 -1 -1 -1 -1 -1 -1 -1 -1 -1 -1 -1 -1 -1 -1 -1 -1 -1 -1 -1 -1 -1 -1 -1 -1 -1 -1 -1 1371 1372
389 390 -1 -1 -1 -1 -1 -1 -1 -1 -1 -1 -1 -1 -1 -1 -1 -1 -1 -1 -1 -1 -1 -1 -1 -1 -1 -1 -1 -1 -1 -1 -1 -1 -1 -1 -1 -1 -1 -1 -1 -1 -1 -1 -1 -1 -1 -1 -1 -1 -1 -1 -1 -1 -1 -1 -1 -1 1310 130
453 454 -1 -1 -1 -1 -1 -1 -1 -1 -1 -1 -1 -1 -1 -1 -1 -1 -1 -1 -1 -1 -1 -1 -1 -1 -1 -1 -1 -1 -1 -1 -1 -1 -1 -1 -1 -1 -1 729 730 648 649 -1 -1 -1 -1 -1 -1 -1 -1 -1 -1 -1 -1 -1 -1 -1 1374 130
-1 -1 -1 -1 -1 -1 -1 -1 -1 -1 673 674 720 721 -1 -1 -1 -1 -1 -1 -1 -1 -1 -1 -1 -1 -1 -1 -1 -1 -1 -1 -1 -1 -1 -1 -1 -1 -1 793 794 712 713 645 646 -1 -1 -1 -1 -1 -1 -1 -1 -1 -1 -1 -1 -1 1307 1308
-1 -1 -1 -1 -1 -1 -1 -1 679 680 737 738 784 785 -1 -1 -1 -1 -1 -1 -1 -1 -1 -1 -1 -1 -1 -1 -1 -1 -1 -1 -1 -1 -1 -1 -1 -1 -1 1307 1308 776 777 709 710 642 643 -1 -1 -1 -1 -1 -1 -1 -1 -1 -1 -1 1371 1372
-1 -1 -1 -1 -1 -1 676 677 743 744 801 802 1294 1295 -1 -1 -1 -1 -1 -1 -1 -1 -1 -1 -1 -1 -1 -1 -1 -1 -1 -1 -1 -1 -1 -1 -1 -1 -1 1371 1372 130 130 773 774 706 707 645 646 -1 -1 -1 -1 -1 -1 -1 -1 -1 1307 1308
-1 -1 -1 -1 673 674 740 741 807 808 130 130 1358 1359 -1 -1 -1 -1 -1 -1 -1 -1 -1 -1 -1 -1 -1 -1 -1 -1 -1 -1 -1 -1 -1 -1 -1 -1 -1 1307 1308 130 130 130 130 770 771 709 710 648 649 -1 -1 -1 -1 -1 -1 -1 1371 1372
1486 1487 1493 1494 737 738 804 805 130 130 130 130 130 1484 1499 1500 1496 1497 1493 1494 1486 1487 1493 1494 1496 1497 1493 1494 1489 1486 1487 1499 1500 1486 1487 1493 1494 1496 1497 1502 130 130 130 130 130 130 130 773 774 712 713 1496 1497 1489 1493 1494 1499 1500 1502 130
1550 1551 1557 1558 801 802 130 130 130 130 130 130 130 1548 1563 1564 1560 1561 1557 1558 1550 1551 1557 1558 1560 1561 1557 1558 1553 1550 1551 1563 1564 1550 1551 1557 1558 1560 1561 1566 130 130 130 130 130 130 130 130 130 776 777 1560 1561 1553 1557 1558 1563 1564 1566 130
