40 20
130 130 130 130 130 398 399 403 404 403 404 410 411 403 404 398 399 410 411 403 404 410 411 406 403 404 398 399 410 411 398 399 410 411 406 404 359 360 360 130
130 70 70 70 524 462 463 467 468 467 468 474 475 467 468 462 463 474 475 467 468 474 475 470 467 468 462 463 474 475 462 463 474 475 470 421 359 360 130 130
130 70 70 389 390 526 527 -1 -1 -1 -1 -1 -1 -1 -1 526 527 -1 -1 -1 -1 -1 -1 534 -1 -1 526 527 -1 -1 526 527 -1 -1 534 485 423 424 410 411
130 70 524 453 454 -1 -1 -1 -1 -1 -1 -1 -1 -1 -1 -1 -1 -1 -1 -1 -1 -1 -1 -1 -1 -1 -1 -1 -1 -1 -1 -1 -1 -1 -1 -1 487 488 474 475
130 1294 1295 -1 -1 -1 -1 -1 -1 -1 -1 -1 -1 -1 -1 -1 -1 -1 -1 -1 -1 -1 -1 -1 -1 -1 -1 -1 -1 -1 -1 -1 -1 -1 -1 -1 -1 -1 -1 -1
130 1358 1359 -1 -1 -1 -1 -1 -1 -1 -1 -1 -1 -1 -1 -1 -1 -1 -1 -1 -1 -1 -1 -1 -1 -1 -1 -1 -1 -1 -1 -1 -1 -1 -1 -1 -1 -1 -1 -1
130 70 1292 -1 -1 -1 -1 -1 -1 -1 -1 -1 -1 -1 -1 -1 -1 -1 -1 -1 -1 -1 -1 -1 -1 -1 -1 -1 -1 -1 -1 -1 -1 -1 -1 -1 -1 -1 -1 -1
70 70 1356 -1 -1 -1 -1 -1 -1 -1 -1 -1 -1 -1 -1 -1 -1 -1 -1 -1 -1 -1 -1 -1 -1 -1 -1 -1 -1 -1 -1 -1 -1 -1 -1 -1 -1 -1 -1 -1
70 70 961 1491 1499 1500 1493 1494 962 963 964 -1 -1 -1 -1 -1 -1 -1 -1 -1 968 969 -1 -1 -1 -1 -1 -1 -1 -1 -1 -1 -1 -1 -1 998 999 1000 1491 1502
70 70 130 1555 1563 1564 386 386 387 1027 1028 -1 -1 -1 -1 -1 -1 -1 -1 -1 -1 -1 -1 -1 -1 -1 -1 -1 -1 -1 -1 -1 -1 -1 -1 1062 1063 1064 542 1566
130 130 130 130 130 524 450 450 451 -1 -1 -1 -1 -1 -1 -1 -1 -1 -1 -1 -1 -1 -1 -1 -1 -1 968 969 -1 -1 -1 -1 -1 -1 -1 -1 -1 -1 1307 1308
130 1358 130 130 389 390 -1 -1 -1 -1 -1 -1 -1 968 969 -1 -1 -1 -1 -1 -1 -1 -1 -1 -1 -1 -1 -1 -1 -1 -1 -1 968 969 -1 -1 -1 -1 1371 1372
403 404 408 524 453 454 -1 -1 -1 -1 -1 -1 -1 -1 -1 -1 -1 -1 -1 -1 -1 -1 -1 -1 -1 -1 -1 -1 -1 -1 -1 -1 -1 -1 -1 -1 -1 -1 1310 130
467 468 472 456 -1 -1 -1 -1 -1 -1 -1 -1 -1 -1 -1 -1 -1 993 994 -1 -1 -1 -1 -1 -1 -1 -1 -1 -1 -1 -1 -1 -1 -1 -1 -1 -1 -1 1374 130
-1 -1 -1 -1 -1 -1 -1 -1 -1 -1 -1 -1 -1 -1 -1 -1 -1 -1 -1 -1 -1 -1 -1 968 969 -1 -1 -1 -1 -1 -1 -1 -1 -1 -1 -1 -1 -1 1310 130
-1 -1 -1 -1 -1 -1 -1 -1 -1 -1 -1 -1 -1 -1 -1 -1 -1 -1 -1 -1 -1 -1 -1 -1 -1 -1 -1 -1 -1 -1 -1 -1 -1 -1 -1 -1 -1 -1 1374 130
-1 -1 -1 -1 -1 -1 -1 -1 -1 -1 -1 -1 -1 -1 -1 -1 -1 -1 -1 -1 -1 -1 -1 -1 -1 -1 -1 -1 -1 -1 -1 -1 -1 -1 -1 -1 -1 -1 1307 1308
-1 -1 -1 -1 -1 -1 -1 -1 -1 -1 -1 -1 -1 -1 -1 -1 -1 -1 -1 -1 -1 -1 -1 -1 -1 -1 -1 -1 -1 -1 -1 -1 -1 -1 -1 -1 -1 -1 1371 1372
1484 1486 1487 1493 1494 1493 1494 1496 1497 1486 1487 1499 1500 1493 1494 1499 1500 1491 1496 1497 1486 1487 1496 1497 1493 1494 1486 1487 1496 1497 1489 1493 1494 1499 1500 1486 1487 1496 1502 130
1548 1550 1551 1557 1558 1557 1558 1560 1561 1550 1551 1563 1564 1557 1558 1563 1564 1555 1560 1561 1550 1551 1560 1561 1557 1558 1550 1551 1560 1561 1553 1557 1558 1563 1564 1550 1551 1560 1566 130
