50 50
130 130 130 130 130 130 130 130 130 130 130 130 130 130 130 130 130 130 130 130 130 130 130 130 130 130 130 130 130 130 130 130 130 130 130 130 130 130 130 130 130 130 130 130 130 130 130 130 130 130
130 130 130 130 130 403 404 398 399 410 411 398 399 403 404 410 411 359 360 130 130 130 130 130 130 130 130 130 130 130 130 322 323 406 398 399 403 404 410 411 359 360 130 130 130 130 130 130 130 130
130 130 130 130 524 467 468 462 463 474 475 462 463 467 468 474 475 423 424 130 130 130 130 130 130 130 130 130 130 322 323 386 387 470 462 463 467 468 474 475 423 424 359 360 130 130 130 130 130 130
130 130 130 389 390 -1 -1 526 527 -1 -1 526 527 -1 -1 -1 -1 487 488 542 130 130 130 130 130 130 130 322 323 386 387 450 451 534 526 527 -1 -1 -1 -1 487 488 423 424 359 360 130 130 130 130
130 130 524 453 454 -1 -1 -1 -1 -1 -1 -1 -1 -1 -1 -1 -1 -1 -1 420 421 359 360 130 130 130 130 386 387 450 451 -1 -1 -1 -1 -1 -1 -1 -1 -1 -1 -1 487 488 423 424 130 130 130 130
130 524 394 -1 -1 -1 -1 -1 -1 -1 -1 -1 -1 -1 -1 -1 -1 -1 -1 484 485 423 424 130 130 130 130 450 451 -1 -1 -1 -1 -1 -1 -1 -1 -1 -1 -1 -1 -1 -1 -1 487 488 542 130 130 130
130 1292 458 -1 -1 -1 -1 -1 -1 -1 -1 -1 -1 -1 -1 -1 -1 -1 -1 -1 -1 487 488 542 130 1294 1295 -1 -1 -1 -1 -1 -1 -1 -1 -1 -1 -1 -1 -1 -1 -1 -1 -1 -1 -1 420 421 130 130
130 1356 -1 -1 -1 -1 -1 -1 -1 -1 -1 -1 -1 -1 -1 -1 -1 -1 -1 -1 -1 -1 -1 1307 1308 1358 1359 -1 -1 -1 -1 -1 -1 -1 -1 -1 -1 -1 -1 -1 -1 -1 -1 -1 -1 -1 484 485 542 130
1294 1295 -1 -1 -1 -1 -1 -1 -1 -1 -1 -1 -1 -1 -1 -1 -1 -1 -1 -1 -1 -1 -1 1371 1372 1294 1295 -1 -1 -1 -1 -1 -1 -1 -1 -1 -1 -1 -1 -1 -1 -1 -1 -1 -1 -1 -1 -1 1307 1308
1358 1359 -1 -1 -1 729 730 720 721 -1 -1 -1 -1 -1 -1 -1 -1 -1 -1 -1 -1 -1 -1 1307 1308 1358 1359 -1 -1 -1 -1 -1 -1 -1 -1 -1 -1 -1 -1 -1 -1 -1 -1 -1 -1 -1 -1 -1 1371 1372
130 1292 -1 -1 -1 793 794 784 785 -1 -1 -1 -1 -1 -1 -1 -1 -1 -1 -1 -1 -1 -1 544 467 468 522 -1 -1 -1 -1 -1 -1 -1 -1 -1 -1 -1 -1 -1 -1 -1 -1 -1 -1 -1 -1 -1 1310 130
130 1356 -1 -1 -1 420 421 1294 1295 -1 -1 -1 -1 -1 -1 -1 -1 -1 -1 -1 -1 -1 -1 -1 -1 -1 -1 -1 -1 -1 -1 -1 -1 -1 -1 -1 -1 -1 -1 -1 -1 -1 -1 -1 -1 -1 -1 -1 1374 130
130 1292 -1 -1 -1 484 485 542 1359 -1 -1 -1 -1 -1 -1 -1 -1 -1 -1 -1 -1 -1 -1 -1 -1 -1 -1 -1 -1 -1 -1 -1 -1 -1 -1 -1 -1 -1 -1 -1 -1 -1 -1 -1 -1 -1 -1 -1 1307 1308
130 1356 -1 -1 -1 -1 -1 1310 1484 720 721 -1 -1 -1 -1 -1 -1 -1 -1 -1 -1 -1 -1 -1 -1 -1 -1 -1 -1 -1 -1 -1 -1 729 730 645 646 -1 -1 -1 -1 -1 -1 -1 -1 -1 -1 -1 1371 1372
1294 1295 -1 -1 -1 -1 -1 1374 1548 784 785 -1 -1 -1 -1 -1 -1 -1 -1 -1 -1 -1 -1 -1 673 674 721 -1 -1 -1 -1 -1 -1 793 794 709 710 720 721 -1 -1 -1 -1 -1 -1 -1 -1 -1 1310 130
1358 1359 -1 -1 -1 -1 -1 1307 1308 1294 1295 -1 -1 -1 -1 -1 -1 -1 -1 -1 -1 -1 673 674 737 738 785 -1 -1 -1 -1 -1 -1 1307 1308 130 130 784 785 -1 -1 -1 -1 -1 -1 -1 -1 -1 1374 130
130 1292 -1 -1 -1 -1 -1 1371 1372 1358 1359 -1 -1 -1 -1 -1 -1 -1 -1 -1 676 677 737 738 1566 389 390 -1 -1 -1 -1 -1 -1 1371 1372 130 130 389 390 -1 -1 -1 -1 -1 -1 -1 729 730 1502 130
389 390 -1 -1 -1 -1 -1 1307 1308 130 1484 1493 1494 1491 1493 1494 1496 1497 1493 1494 740 741 130 386 387 453 454 -1 -1 -1 -1 -1 -1 1307 1308 130 524 453 454 -1 -1 -1 -1 -1 -1 -1 793 794 1566 130
453 454 -1 -1 -1 -1 -1 1371 1372 130 1548 1557 1558 1555 1557 1558 1560 1561 1557 1558 130 386 387 450 451 -1 -1 -1 -1 -1 -1 -1 -1 1371 1372 524 522 -1 -1 -1 -1 -1 -1 -1 -1 -1 420 421 130 130
-1 -1 -1 -1 -1 -1 -1 420 421 130 130 130 130 130 130 386 387 462 463 467 468 450 451 -1 -1 -1 -1 -1 -1 -1 -1 729 730 1502 1294 1295 -1 -1 -1 -1 -1 -1 -1 -1 -1 -1 484 485 542 130
-1 -1 -1 -1 -1 -1 -1 484 485 542 130 130 130 130 524 450 451 526 527 -1 -1 -1 -1 -1 -1 -1 -1 -1 -1 -1 -1 793 794 1566 1358 1359 -1 -1 -1 -1 -1 -1 -1 -1 -1 -1 -1 -1 1310 130
-1 -1 -1 -1 -1 -1 -1 -1 -1 420 421 130 130 1294 1295 -1 -1 -1 -1 -1 -1 -1 -1 -1 -1 -1 -1 -1 -1 729 730 1502 130 130 389 390 -1 -1 -1 729 730 720 721 -1 -1 -1 -1 -1 1310 130
-1 -1 -1 -1 -1 -1 -1 -1 -1 484 485 542 130 1358 1359 -1 -1 -1 -1 -1 -1 -1 -1 -1 -1 -1 -1 -1 -1 793 794 1566 130 524 453 454 -1 -1 -1 544 462 463 522 -1 -1 -1 -1 -1 1374 130
-1 -1 -1 -1 -1 -1 -1 -1 -1 -1 -1 1371 1372 130 1292 -1 -1 -1 -1 -1 -1 -1 -1 -1 -1 -1 676 677 1489 1502 130 130 389 390 -1 -1 -1 -1 -1 -1 526 527 -1 -1 -1 -1 -1 -1 1307 1308
-1 -1 -1 -1 -1 -1 -1 -1 -1 -1 -1 420 421 130 1356 -1 -1 -1 -1 -1 -1 -1 -1 673 674 1489 740 741 1553 398 399 524 453 454 -1 -1 -1 -1 -1 -1 -1 -1 -1 -1 -1 -1 -1 -1 1371 1372
1484 720 721 -1 -1 -1 -1 -1 -1 -1 -1 484 485 542 1484 1493 1494 1496 1497 1499 1500 1486 1487 737 738 1553 130 386 387 462 463 -1 -1 -1 -1 -1 -1 -1 -1 -1 -1 -1 -1 -1 -1 -1 729 730 1502 130
1548 784 785 -1 -1 -1 -1 -1 -1 -1 -1 -1 -1 420 421 1557 1558 1560 1561 1563 1564 1550 1551 398 399 386 387 450 451 526 527 -1 -1 -1 -1 -1 -1 -1 -1 -1 -1 -1 -1 -1 -1 -1 793 794 1566 130
130 524 522 -1 -1 -1 -1 -1 -1 -1 -1 -1 -1 484 485 474 475 467 468 462 463 474 475 462 463 450 451 -1 -1 -1 -1 -1 -1 -1 -1 -1 -1 -1 -1 -1 -1 729 730 1493 1494 1489 1502 130 130 130
1294 1295 -1 -1 -1 -1 -1 -1 -1 -1 -1 -1 -1 -1 -1 -1 -1 -1 -1 526 527 -1 -1 526 527 -1 -1 -1 -1 -1 -1 -1 -1 -1 -1 -1 -1 -1 -1 -1 -1 793 794 1557 1558 1553 1566 130 130 130
1358 1359 -1 -1 -1 -1 -1 -1 -1 -1 -1 -1 -1 -1 -1 -1 -1 -1 -1 -1 -1 -1 -1 -1 -1 -1 -1 -1 -1 -1 -1 -1 -1 -1 -1 -1 -1 -1 -1 -1 -1 420 421 410 411 359 360 130 130 130
130 1292 -1 -1 -1 -1 -1 -1 -1 -1 -1 -1 -1 -1 -1 -1 -1 -1 -1 -1 -1 -1 -1 -1 -1 -1 -1 -1 -1 -1 -1 -1 -1 -1 -1 -1 -1 -1 -1 -1 -1 484 485 474 475 423 424 130 130 130
130 1356 -1 -1 -1 -1 -1 -1 729 730 1493 1494 1486 1487 1496 1497 1493 1494 1493 1494 1489 1486 1487 1496 1497 720 721 -1 -1 -1 -1 -1 729 730 1491 720 721 -1 -1 -1 -1 -1 -1 -1 -1 487 488 542 130 130
130 1292 -1 -1 -1 -1 -1 -1 793 794 1557 1558 1550 1551 1560 1561 1557 1558 1557 1558 1553 1550 1551 1560 1561 784 785 -1 -1 -1 -1 -1 793 794 1555 784 785 -1 -1 -1 -1 -1 -1 -1 -1 -1 -1 1307 1308 130
130 1356 -1 -1 -1 -1 -1 -1 420 421 410 411 398 399 410 411 410 411 403 404 410 411 403 404 130 1294 1295 -1 -1 -1 -1 -1 1307 1308 130 1294 1295 -1 -1 -1 -1 -1 -1 -1 -1 -1 -1 1371 1372 130
1294 1295 -1 -1 -1 -1 -1 -1 484 485 474 475 462 463 474 475 474 475 467 468 474 475 467 468 542 1358 1359 -1 -1 -1 -1 -1 1371 1372 130 130 1484 648 649 -1 -1 -1 -1 -1 -1 -1 -1 1310 130 130
1358 1359 -1 -1 -1 -1 -1 -1 -1 -1 -1 -1 526 527 -1 -1 -1 -1 -1 -1 -1 -1 -1 -1 1310 130 1292 -1 -1 -1 -1 -1 1310 130 130 130 1548 712 713 1491 720 721 -1 -1 -1 -1 -1 1307 1308 130
1294 1295 -1 -1 -1 -1 -1 -1 -1 -1 -1 -1 -1 -1 -1 -1 -1 -1 -1 -1 -1 -1 -1 -1 1307 1308 1356 -1 -1 -1 -1 -1 1374 130 130 130 130 1557 1558 386 387 522 -1 -1 -1 -1 -1 1371 1372 130
1358 1359 -1 -1 -1 -1 -1 -1 -1 -1 -1 -1 -1 -1 -1 -1 -1 -1 -1 -1 -1 -1 -1 -1 1371 1358 1359 -1 -1 -1 -1 -1 1307 1308 130 322 323 386 387 450 451 -1 -1 -1 -1 -1 -1 1310 130 130
130 1292 -1 -1 -1 -1 -1 -1 -1 -1 -1 -1 -1 -1 -1 -1 -1 -1 -1 -1 -1 -1 -1 -1 1310 1294 1295 -1 -1 -1 -1 -1 1371 1372 130 386 387 450 451 -1 -1 -1 -1 -1 -1 -1 -1 1374 130 130
130 1356 -1 -1 -1 -1 -1 -1 -1 -1 -1 -1 -1 -1 -1 -1 -1 -1 -1 -1 -1 -1 -1 -1 1374 1358 1359 -1 -1 -1 -1 -1 1307 1308 524 450 451 -1 -1 -1 -1 -1 -1 -1 -1 729 730 1502 130 130
1294 1295 -1 -1 -1 -1 -1 -1 729 730 1493 1494 1496 1497 1493 1494 1499 1500 1493 1494 1496 1497 1493 1494 1502 130 1292 -1 -1 -1 -1 -1 1371 1294 1295 -1 -1 -1 -1 -1 -1 -1 -1 -1 -1 793 794 1566 130 130
1358 1359 -1 -1 -1 -1 -1 -1 793 794 1557 1558 1560 1561 1557 1558 1563 1564 1557 1558 1560 1561 1557 1558 1566 130 1356 -1 -1 -1 -1 -1 1310 1358 1359 -1 -1 -1 -1 -1 -1 -1 -1 -1 -1 544 542 130 130 130
130 1292 -1 -1 -1 -1 -1 -1 420 421 406 410 411 403 404 410 411 398 399 410 411 403 404 398 399 389 390 -1 -1 -1 -1 -1 1374 406 1359 -1 -1 -1 -1 -1 -1 -1 -1 -1 -1 -1 420 421 130 130
130 1356 -1 -1 -1 -1 -1 -1 484 485 470 474 475 467 468 474 475 462 463 474 475 467 468 462 463 453 454 -1 -1 -1 -1 -1 544 470 522 -1 -1 -1 -1 -1 729 730 721 -1 -1 -1 484 485 542 130
130 1292 -1 -1 -1 -1 -1 -1 -1 -1 534 -1 -1 -1 -1 -1 -1 526 527 -1 -1 -1 -1 526 527 -1 -1 -1 -1 -1 -1 -1 -1 534 -1 -1 -1 -1 -1 -1 544 470 522 -1 -1 -1 -1 -1 1307 1308
130 1356 -1 -1 -1 -1 -1 -1 -1 -1 -1 -1 -1 -1 -1 -1 -1 -1 -1 -1 -1 -1 -1 -1 -1 -1 -1 -1 -1 -1 -1 -1 -1 -1 -1 -1 -1 -1 -1 -1 -1 534 -1 -1 -1 -1 -1 -1 1371 1372
1294 1295 -1 -1 -1 -1 -1 -1 -1 -1 -1 -1 -1 -1 -1 -1 -1 -1 -1 -1 -1 -1 -1 -1 -1 -1 -1 -1 -1 -1 -1 -1 -1 -1 -1 -1 -1 -1 -1 -1 -1 -1 -1 -1 -1 -1 -1 -1 1310 130
1358 1359 -1 -1 -1 -1 -1 -1 -1 -1 -1 -1 -1 -1 -1 -1 -1 -1 -1 -1 -1 -1 -1 -1 -1 -1 -1 -1 -1 -1 -1 -1 -1 -1 -1 -1 -1 -1 -1 -1 -1 -1 -1 -1 -1 -1 -1 -1 1374 130
130 1484 1486 1487 1493 1494 1499 1500 1493 1494 1486 1487 1496 1497 1499 1500 1493 1494 1499 1500 1496 1497 1496 1497 1486 1487 1493 1494 1486 1487 1496 1497 1499 1500 1493 1494 1496 1497 1493 1494 1496 1497 1499 1500 1493 1494 1499 1500 1502 130
130 1548 1550 1551 1557 1558 1563 1564 1557 1558 1550 1551 1560 1561 1563 1564 1557 1558 1563 1564 1560 1561 1560 1561 1550 1551 1557 1558 1550 1551 1560 1561 1563 1564 1557 1558 1560 1561 1557 1558 1560 1561 1563 1564 1557 1558 1563 1564 1566 130
